44444444444444444444444444444444
49919999999199999919999999999994
41991119119111911991191119155554
41199119919991911199199199959994
49919911911191999919919191959194
41911911999191195555555191959194
41911999119191195955995995559194
49991119919199995999195555999194
49199111999119115559199955911994
49119991111199192959911559919914
49111199919992222955999599199194
49119111919222999995591555591194
49999191999291111191599999599994
45559991122299999199595555519114
49955599929991911119555999919914
41919555555191919999959911911994
41919999195555999555559199999194
49999111199995955599919191111194
49119991911195559191999199199994
49911199119195599111111119191914
41991119919199991119999919191994
49199991919111111199191119191194
49111191919991999991191999191994
49999991911199919199191911111914
49111111199111919111191919999994
49991999919911911999191911191194
41191191911991111919191991191114
49199991919911991919191199199994
49111111919111199919191119111194
49999991911119111119911999911994
49111199999999999991999911999914
44444444444444444444444444444444