441444444414444441444444444444
144111411411141144114111415555
114411441444141114414414445444
441441141114144441441414145414
141141144414114555555514145414
141144411414114545544544555414
444111441414444544414555544414
414411144411422555414445541144
411444111114424145441155441441
411114441444221145544454414414
411411141422244444554155554114
444414144424111114154444454444
555444112224444414454555551411
445554442444141111455544441441
141455555514141444445441141144
141444414555544455555414444414
444411114444545554441414111114
411444141114555414144414414444
441114411414554411111111414141
144111441414444111444441414144
414444141411111114414111414114
411114141444144444114144414144
444444141114441414414141111141
411111114411141411114141444444
444144441441141144414141114114
114114141144111141414144114111
414444141441144141414114414444
411111141411114441414111411114
444444141111411111441144441144
411114444444444444144441144441
