44444444444444444444444444444444
49999999999999999999999999999994
49000009000055555555555955595554
49999909999959999999095959595534
49000900090959000009095559555924
49990909990959099999990999099924
49000909090059090000090909090924
49099909099959090999999909990924
49090900090959000000090009222224
49090999090959099999999909299994
49000009095559000009000922290004
49990999095999099909099929090994
49090909095000000900092229090904
49090909095909999999992999990904
49090900095900000909222009090004
49090909995999999909299999090994
49090909555009000922200000090004
49090909592999099929999909990994
49090055592222222220000909090004
49099959999909999909090909090994
49095550000900000909090900000004
49095999999999990999990999099904
49095000000000090009090009000904
49095999090999099999099909990904
49555009090909090000090900090904
49599999999909090909090999999904
40590000000009000909090009000904
40590909999999099999990999090904
47500900000900000000000000090904
49090909990999099909099999099904
49090900090009000909000009000904
44444444444444444444444444444444