111111111111111111111111111113
001010001000000000000010001000
001010111011111110101010111110
200000000000001010101000101000
101110111110111011111111101011
100010000010000000000010000000
101110101110111011111010111110
101000100010001000001000000010
111011101111111110111011101011
100010000000000010001000101000
101010101010111010101110111011
101010101010001010100010001000
111011101011101010111111111110
100010101010001010001010001010
111010101110111010111010111011
101010100010001010000000000000
101010101110101110111011111111
100000101000101010001000101010
111010111110101011111010101010
100010101000100000001010101000
111110101110101010101010101011
100010000010101010101010000000
111010111111111011101011101110
100000100010000000101000100010
111110101111101011111011111110
100000000000101000101000000010
101110101111101010101110111011
101000100000101010000010001000
111010101011111010101010111111
100010101000001010101010000000
