000000000000000000000000000000
011101010111011101111101010111
000101010100010001000101010101
011111010111110111110101010101
000001010001010100000001010100
010111011111011111110111110111
010001000001000100000001010100
011101110101010111011111010113
000100010101010000010001000100
011111011111111101010101110111
000100010000000001010100000100
010101111101111111011111010111
010100010001000000010100010100
011111110111110101010111010111
010000000100000101010000010100
010111010101010111010111010111
010001010101010100010100010100
010111010111011111110101111101
010100010001000001000101000101
010111110111110111111111110111
010100000001010100010000010000
011111011101011111011101011111
010000010000010101000001010000
111111111101110101111101011111
110100010101010000000001000001
211111010111010101111101011101
100100000101010101000001010101
011101011101010101010111110101
000101000101000101010100000001
011111110101111111111111111101
