44444444444444444444444444444444
49111919111119111919111919191114
49991919199999191919199919191994
49111911111111191919191911111114
49991919199999199919191999199994
49111919191119111119111911111114
49991919999919999999991919999994
49191119191111111919111111111114
49199919191999999919999919199914
49191119191919111119111119111914
49199919191919199999199919191914
49191919111111191119191119191914
49191919199999191999991999199994
41111955511119191119111119111914
41199959599999991999991999999914
42111959555555555555555111195554
45591959999999999999995999995534
49555551111919111119195555555554
49999919991919199999191999191994
49111111191111111111191919191114
49191919199919991919999919199994
49191919191911191911191911111114
49191999191919991919991919199994
49191119111919111911111919111114
49199919199919999919199999199914
49111919111919191919111119111914
49991999199999191919199999999994
49111911111111111919111111111114
49991919999919991999191919191994
49111911111911191119191919191114
49999999999999999999999999999994
44444444444444444444444444444444