44444444444444444444444444444444
49999999999999999999999999999934
45590900090000000000000900090054
45590909990999999909090909999954
47555555555550090909090009095554
49099909999959990999999999095994
49000900000955555555555955555004
49099909099909990999995959999904
49090009000900090000095550000904
49990999099999999909990999090994
49000900000000000900090009090004
49090909090909990909099909990994
49090909090900090909000900090004
49990999090999090909999999999904
49000909090900090900090900090904
49990909099909990909990909990994
49090909000900090900000000000004
49090909099909099909990999999994
49000009090009090900090009090904
49990909999909090999990909090904
49000909090009000000090909090004
49999909099909090909090909090994
49000900000909090909090900000004
49990909999999990999090999099904
49000009000900000009090009000904
49999909099999090999990999999904
49000000000009090009090000000904
49099909099999090909099909990994
49090009000009090900000900090004
49990909090999990909090909999994
49000909090000090909090900000004
44444444444444444444444444444444