441444444414444441444444444444
144111411411141144114111412222
114411441444141114414414442444
441441141114144441441414142414
141141144414114222222214142414
141144411414114241144244222414
444111441414444244414222244414
414411144411422211414441141144
411444111114424141441111441441
411114441444221141144414414414
411411141422244444114111114114
444414144424111114114444414444
222444112224444414414111111411
442224442444141111411144441441
141422222114141444441441141144
141444414111144411111414444414
444411114444141114441414111114
411444111114111414144414414444
441114411414114411111111414141
144111441414444111444441414144
414444141411111114414111414114
411114141444144444114144414144
444444141114441414414141111141
411111114411141411114141444444
444144441441141144414141114114
114114141144111141414144114111
414444141441144141414114414444
411111141411114441414111411114
444444141111411111441144441144
411114444444444444144441144441
