011101011111011101011101010111
000101010000010101010001010100
011101111111110101010101111111
000101010000010001010100010000
011101010111011111011101111111
000101000001000000000101000000
010111010111111101011111111111
010001010100000001000001010001
010111010101011111011111011101
010001010101010000010001010101
010101011111110111010111010101
010101010000010100000100010000
111101111111010111011111011101
110001010000000100000100000001
211101011111111111111111110111
110101000000000000000100000113
011111111101011111010111111111
000001000101010000010100010100
011111110111111111110101010111
010101010001000101000001010000
010101010101110101110101111111
010100010101000101000101010000
010111011101011101111101011111
010001010001000001010000010001
011101011101010101011111011101
000100010000010101010000000000
011101111111111101011111111111
000101000001000100010101010100
011101111101110111010101010111
000000000000000000000000000000
