111111111111111111111111111111
100000100000000000000010001000
111110111110111111101010101003
100010001010100000101000100010
111010111010101111111011101110
100010101000101000001010101010
101110101110101011111110111010
101010001010100000001000100000
101011101010101111111110101111
100000101000100000100010001000
111011101011101110101110101011
101010101000000010001000101010
101010101010111111111011111010
101010001010000010100000101000
101010111011111110101111101011
101010100000100010000000001000
101010101011101110111110111011
101000001000000000000010101000
101110111110111110101010101011
101000000010000010101010000000
101011111111111011111011101110
101000000000001000101000100010
101011101011101111101110111010
100000101010101000001010001010
101111111110101010101011111110
001000000000100010101000100010
001010111111101111111011101010
200010000010000000000000001010
101010111011101110101111101110
101010001000100010100000100010
